#########################################################################
#...#...............#...............#...........#...................#.@.#
#...#...#########...#...#####...#########...#####...#####...#####...#...#
#...............#.......#...#...........#...........#...#...#.......#...#
#########...#...#########...#########...#####...#...#...#...#########...#
#.......#...#...............#....!......#...#...#...#...#...........#...#
#...#...#############...#...#...#########...#####...#...#########...#...#
#...#...............#...#...#!......#...........#...........#.......#...#
#...#############...#####...#####...#...#####...#########...#...#####...#
#...........#.......#...#.!.....#...#.......#...........#...#...........#
#...#####...#####...#.!.#####...#...#########...#...#...#...#############
#!......#.......#...#...#.......#.......#.......#...#...#.......#.......#
#############...#...#...#...#########...#...#####...#...#####...#####...#
#...!.......#...#!..........#.......#...#.......#...#.......#...........#
#...#####...#...#########...#####...#...#####...#####...#############...#
#...#.......#...........#...........#.......#...#...#...............#...#
#...#...#########...#...#####...#########...#...#...#############...#...#
#...#...........#...#...#...#...#...........#...............#...#.......#
#...#########...#...#...#...#####...#########...#########...#...#########
#...#.......#...#...#...........#...........#...#.......#...............#
#...#...#####...#####...#####...#########...#####...#...#########...#...#
#.>.#...................#...........#...............#...............#...#
#########################################################################
