                             ##################
                     #########................#########
               #######................................#######
          ######............................................######
       ####.@......................................!.............####
     ###............................................................###
   ###................................................................###
 ###....................................................................###
 #.....................................!...........!......................#
 #........................................................................#
 #......................................!.................................#
 ###....................................................................###
   ###...................................!............................###
     ###..................................!.........................###
       ####................................!..............>......####
          ######....................!...!..!................######
               #######................................#######
                     #########................#########
                             ##################
