########################################
#@.....................................#
#......................................#
#....#....#.!..........................#
#......................................#
#......................................#
#....######............................#
#.........!.....................!......#
#......................................#
#.######################################
#.....!........................!.......#
##############.........................#
##############.........................#
##############.........................#
##############.........................#
##############.........................#
#..!..........................!........#
#.######################################
#......................................#
###...!....#.............!.............#
#>##.....####..........................#
#..##..###..#..........................#
#.!.####.............!.................#
#....##.!........!.....................#
#......................................#
#....!........!........................#
#......................................#
########################################
